{
  "version": 1,
  "width": 30,
  "height": 20,
  "tile_size": 32,
  "tileset": "assets/textures/tileset.png",
  "layers": [
    {
      "name": "ground",
      "data": [
        18,18,18,18,18,18,18,0,18,18,18,18,18,18,18,18,18,18,18,18,18,18,18,18,18,18,18,18,18,18,
        18,1,0,3,2,1,4,0,2,1,4,3,2,1,4,3,2,1,4,3,2,1,4,3,2,1,4,3,2,18,
        18,2,0,4,3,2,1,4,3,2,1,4,3,2,1,4,3,2,1,4,3,2,1,4,3,2,1,4,3,18,
        18,3,2,1,4,3,2,1,4,3,2,1,4,3,2,2,2,3,2,1,4,3,2,1,4,3,2,1,4,18,
        18,4,3,2,1,21,21,21,21,21,21,21,1,2,2,2,2,4,3,22,22,22,22,22,22,4,3,2,1,18,
        18,1,4,3,2,1,4,3,2,1,4,3,2,2,2,2,2,2,8,5,6,7,8,3,2,1,4,3,2,18,
        18,2,1,4,3,2,1,4,3,2,1,4,3,2,2,2,2,2,5,6,7,8,5,4,3,2,1,4,3,18,
        18,3,2,1,2,2,2,1,4,3,2,1,2,5,2,2,2,2,6,7,8,5,2,1,2,3,2,1,4,18,
        18,16,16,16,16,16,16,16,16,16,16,16,16,16,16,10,16,16,16,16,16,16,16,16,16,16,16,16,16,18,
        18,9,9,9,9,9,9,9,9,9,9,9,9,9,9,10,9,9,9,9,9,9,9,9,9,9,9,9,9,18,
        18,10,10,10,10,10,10,10,10,10,10,10,10,10,10,10,10,10,10,10,10,10,10,10,10,9,9,9,9,18,
        18,16,16,16,16,16,16,16,16,16,16,16,16,16,16,16,16,16,16,16,16,16,16,16,16,16,16,16,16,18,
        18,4,3,2,1,4,3,2,1,4,3,2,1,4,3,2,1,4,3,2,1,4,3,2,1,4,3,2,1,18,
        18,1,4,3,2,1,4,3,2,1,4,3,2,1,4,3,2,1,4,3,2,1,4,3,2,1,4,3,2,18,
        18,2,1,4,3,2,1,4,3,2,1,4,3,2,1,4,3,2,1,4,3,2,20,18,17,17,17,18,20,18,
        18,3,2,1,4,3,2,1,4,3,2,1,4,3,2,1,4,3,2,1,4,3,18,17,17,17,17,17,18,18,
        18,4,3,2,1,4,3,2,1,4,3,2,1,4,3,2,1,4,3,2,1,4,18,17,17,17,17,17,18,18,
        18,1,4,3,2,1,4,3,2,1,4,3,2,1,4,3,2,1,4,3,2,1,18,17,17,17,17,17,18,18,
        18,2,1,4,3,2,1,4,3,2,1,4,3,2,1,4,3,2,1,4,3,2,20,18,17,17,17,18,20,18,
        18,18,18,18,18,18,18,18,18,18,18,18,18,18,18,18,18,18,18,18,18,18,18,18,18,18,18,18,18,18
      ]
    }
  ],
  "collision": [
    1,1,1,1,1,1,1,1,1,1,1,1,1,1,1,1,1,1,1,1,1,1,1,1,1,1,1,1,1,1,
    1,0,0,0,0,0,0,0,0,0,0,0,0,0,0,0,0,0,0,0,0,0,0,0,0,0,0,0,0,1,
    1,0,0,0,0,0,0,0,0,0,0,0,0,0,0,0,0,0,0,0,0,0,0,0,0,0,0,0,0,1,
    1,0,0,0,0,0,0,0,0,0,0,0,0,0,0,0,0,0,0,0,0,0,0,0,0,0,0,0,0,1,
    1,0,0,0,0,1,1,1,1,1,1,1,0,0,0,0,0,0,0,1,1,1,1,1,1,0,0,0,0,1,
    1,0,0,0,0,0,0,0,0,0,0,0,0,0,0,0,0,0,0,0,0,0,0,0,0,0,0,0,0,1,
    1,0,0,0,0,0,0,0,0,0,0,0,0,0,0,0,0,0,0,0,0,0,0,0,0,0,0,0,0,1,
    1,0,0,0,0,0,0,0,0,0,0,0,0,0,0,0,0,0,0,0,0,0,0,0,0,0,0,0,0,1,
    1,0,0,0,0,0,0,0,0,0,0,0,0,0,0,0,0,0,0,0,0,0,0,0,0,0,0,0,0,1,
    1,0,0,0,0,0,0,0,0,0,0,0,0,0,0,0,0,0,0,0,0,0,0,0,0,0,0,0,0,1,
    1,0,0,0,0,0,0,0,0,0,0,0,0,0,0,0,0,0,0,0,0,0,0,0,0,0,0,0,0,1,
    1,0,0,0,0,0,0,0,0,0,0,0,0,0,0,0,0,0,0,0,0,0,0,0,0,0,0,0,0,1,
    1,0,0,0,0,0,0,0,0,0,0,0,0,0,0,0,0,0,0,0,0,0,0,0,0,0,0,0,0,1,
    1,0,0,0,0,0,0,0,0,0,0,0,0,0,0,0,0,0,0,0,0,0,0,0,0,0,0,0,0,1,
    1,0,0,0,0,0,0,0,0,0,0,0,0,0,0,0,0,0,0,0,0,0,0,1,1,1,1,1,0,1,
    1,0,0,0,0,0,0,0,0,0,0,0,0,0,0,0,0,0,0,0,0,0,1,1,1,1,1,1,1,1,
    1,0,0,0,0,0,0,0,0,0,0,0,0,0,0,0,0,0,0,0,0,0,1,1,1,1,1,1,1,1,
    1,0,0,0,0,0,0,0,0,0,0,0,0,0,0,0,0,0,0,0,0,0,1,1,1,1,1,1,1,1,
    1,0,0,0,0,0,0,0,0,0,0,0,0,0,0,0,0,0,0,0,0,0,0,1,1,1,1,1,0,1,
    1,1,1,1,1,1,1,1,1,1,1,1,1,1,1,1,1,1,1,1,1,1,1,1,1,1,1,1,1,1
  ],
  "portals": [
  ]
}
