{
  "version": 1,
  "width": 30,
  "height": 20,
  "tile_size": 32,
  "tileset": "assets/textures/tileset.png",
  "layers": [
    {
      "name": "ground",
      "data": [
        18,18,18,18,18,18,18,18,18,18,18,18,18,18,18,18,18,18,18,18,18,18,18,18,18,18,18,18,18,18,
        18,1,4,3,2,1,4,3,2,1,4,3,2,1,4,3,2,1,4,3,2,1,4,3,2,1,4,3,2,18,
        18,2,1,4,3,2,1,4,3,2,1,4,3,2,1,4,3,2,1,4,3,2,1,4,3,2,1,4,3,18,
        18,3,2,1,4,3,2,1,4,3,2,1,4,3,23,23,23,3,2,1,4,3,2,1,4,3,2,1,4,18,
        18,4,3,2,1,21,21,21,21,21,21,21,3,4,3,4,3,4,3,22,22,22,22,22,22,4,3,2,1,18,
        18,1,4,3,2,1,4,3,2,1,4,3,2,25,26,23,24,25,8,5,6,7,8,3,2,1,4,3,2,18,
        18,2,1,4,3,2,1,4,3,2,1,4,3,4,3,4,3,4,5,6,7,8,5,4,3,2,1,4,3,18,
        18,3,2,1,4,3,2,1,4,3,2,1,3,4,3,4,3,4,6,7,8,5,6,1,4,3,2,1,4,18,
        18,16,16,16,16,16,16,16,16,16,16,16,16,16,16,16,16,16,16,16,16,16,16,16,16,16,16,16,16,18,
        18,9,9,9,9,9,9,9,9,9,9,9,9,9,9,9,9,9,9,9,9,9,9,9,9,9,9,9,9,18,
        18,9,9,9,9,9,9,9,9,9,9,9,9,9,9,9,9,9,9,9,9,9,9,9,9,9,9,9,9,18,
        18,16,16,16,16,16,16,16,16,16,16,16,16,16,16,16,16,16,16,16,16,16,16,16,16,16,16,16,16,18,
        18,4,3,2,1,4,3,2,1,4,3,2,1,4,3,2,1,4,3,2,1,4,3,2,1,4,3,2,1,18,
        18,1,4,3,2,1,4,3,2,1,4,3,2,1,4,3,2,1,4,3,2,1,4,3,2,1,4,3,2,18,
        18,2,1,4,3,2,1,4,3,2,1,4,3,2,1,4,3,2,1,4,3,2,20,18,17,17,17,18,20,18,
        18,3,2,1,4,3,2,1,4,3,2,1,4,3,2,1,4,3,2,1,4,3,18,17,17,17,17,17,18,18,
        18,4,3,2,1,4,3,2,1,4,3,2,1,4,3,2,1,4,3,2,1,4,18,17,17,17,17,17,18,18,
        18,1,4,3,2,1,4,3,2,1,4,3,2,1,4,3,2,1,4,3,2,1,18,17,17,17,17,17,18,18,
        18,2,1,4,3,2,1,4,3,2,1,4,3,2,1,4,3,2,1,4,3,2,20,18,17,17,17,18,20,18,
        18,18,18,18,18,18,18,18,18,18,18,18,18,18,18,18,18,18,18,18,18,18,18,18,18,18,18,18,18,18
      ]
    }
  ],
  "collision": [
    1,1,1,1,1,1,1,1,1,1,1,1,1,1,1,1,1,1,1,1,1,1,1,1,1,1,1,1,1,1,
    1,0,0,0,0,0,0,0,0,0,0,0,0,0,0,0,0,0,0,0,0,0,0,0,0,0,0,0,0,1,
    1,0,0,0,0,0,0,0,0,0,0,0,0,0,0,0,0,0,0,0,0,0,0,0,0,0,0,0,0,1,
    1,0,0,0,0,0,0,0,0,0,0,0,0,0,0,0,0,0,0,0,0,0,0,0,0,0,0,0,0,1,
    1,0,0,0,0,1,1,1,1,1,1,1,0,0,0,0,0,0,0,1,1,1,1,1,1,0,0,0,0,1,
    1,0,0,0,0,0,0,0,0,0,0,0,0,0,0,0,0,0,0,0,0,0,0,0,0,0,0,0,0,1,
    1,0,0,0,0,1,2,0,0,0,0,0,0,0,0,0,0,0,1,0,0,0,0,0,0,0,0,0,0,1,
    1,0,0,0,0,0,0,0,0,0,0,0,0,0,0,0,0,0,0,1,0,1,0,0,0,0,0,0,0,1,
    1,0,0,0,0,0,0,0,0,0,0,0,0,0,0,0,0,0,0,0,0,0,0,0,0,0,0,0,0,1,
    1,0,0,0,0,0,0,0,0,0,0,0,0,0,0,0,0,0,0,0,0,0,0,0,0,0,0,0,0,1,
    1,0,0,0,0,0,0,0,0,0,0,0,0,0,0,0,0,0,0,0,0,0,0,0,0,0,0,0,0,1,
    1,0,0,0,0,0,0,0,0,0,0,0,0,0,0,0,0,0,0,0,0,0,0,0,0,0,0,0,0,1,
    1,0,0,0,0,0,0,0,0,0,0,0,0,0,0,0,0,0,0,0,0,0,0,0,0,0,0,0,0,1,
    1,0,0,0,0,0,0,0,0,0,0,0,0,0,0,0,0,0,0,0,0,0,0,0,0,0,0,0,0,1,
    1,0,0,0,0,0,0,0,0,0,0,0,0,0,0,0,0,0,0,0,0,0,0,1,1,1,1,1,0,1,
    1,0,0,0,0,0,0,0,0,0,0,0,0,0,0,0,0,0,0,0,0,0,1,1,1,1,1,1,1,1,
    1,0,0,0,0,0,0,0,0,0,0,0,0,0,0,0,0,0,0,0,0,0,1,1,1,1,1,1,1,1,
    1,0,0,0,0,0,0,0,0,0,0,0,0,0,0,0,0,0,0,0,0,0,1,1,1,1,1,1,1,1,
    1,0,0,0,0,0,0,0,0,0,0,0,0,0,0,0,0,0,0,0,0,0,0,1,1,1,1,1,0,1,
    1,1,1,1,1,1,1,1,1,1,1,1,1,1,1,1,1,1,1,1,1,1,1,1,1,1,1,1,1,1
  ],
  "portals": [
    {"x":6,"y":6,"target_map":"","target_x":0,"target_y":0,"label":"portal"}
  ]
}
