{
  "format": "twilight_map",
  "version": 2,
  "metadata": {
    "name": "untitled",
    "width": 30,
    "height": 20,
    "tile_size": 32,
    "tileset": "assets/textures/new_tileset.png",
    "player_start_x": 480,
    "player_start_y": 320
  },
  "layers": [
    {"name": "ground", "data": [
      42,43,42,42,42,42,42,42,42,42,42,42,42,42,42,42,42,42,42,42,42,42,42,42,42,42,42,42,46,42,
      42,43,43,43,43,43,43,43,43,43,43,43,43,43,43,43,43,43,43,43,43,43,43,43,43,43,43,43,46,42,
      42,43,1,1,2,3,1,2,3,1,1,2,1,1,2,3,1,2,3,1,1,2,1,1,2,3,1,2,46,42,
      42,43,2,1,1,2,3,1,2,3,1,1,2,1,1,2,3,1,2,3,1,1,2,1,1,2,3,1,46,42,
      42,43,1,2,1,1,2,3,1,2,3,1,1,2,1,1,2,3,1,2,3,1,1,2,1,1,2,3,46,42,
      42,43,1,1,2,1,1,2,3,1,2,3,1,1,2,1,1,2,3,1,2,3,1,1,2,1,1,2,46,42,
      42,43,3,1,1,2,1,1,2,3,1,2,3,1,1,2,1,1,2,3,1,2,3,1,1,2,1,1,46,42,
      42,43,2,3,1,1,2,1,1,2,3,1,2,3,1,1,2,1,1,2,3,1,2,3,1,1,2,1,46,42,
      42,43,1,2,3,1,1,2,1,1,2,3,1,2,3,1,1,2,1,1,2,3,1,2,3,1,1,2,46,42,
      42,43,3,1,2,3,1,1,2,1,1,2,3,1,2,3,1,1,2,1,1,2,3,1,2,3,1,1,46,42,
      42,43,2,3,1,2,3,1,1,2,1,1,2,3,1,2,3,1,1,2,1,1,2,3,1,2,3,1,46,42,
      42,43,1,2,3,1,2,3,1,1,2,1,1,2,3,1,2,3,1,1,2,1,1,2,3,1,2,3,46,42,
      42,43,1,1,2,3,1,2,3,1,1,2,1,1,2,3,1,2,3,1,1,2,1,1,2,3,1,2,46,42,
      42,43,2,1,1,2,3,1,2,3,1,1,2,1,1,2,3,1,2,3,1,1,2,1,1,2,3,1,46,42,
      42,43,1,2,1,1,2,3,1,2,3,1,1,2,1,1,2,3,1,2,3,1,1,2,1,1,2,3,46,42,
      42,43,1,1,2,1,1,2,3,1,2,3,1,1,2,1,1,2,3,1,2,3,1,1,2,1,1,2,46,42,
      42,43,3,1,1,2,1,1,2,3,1,2,3,1,1,2,1,1,2,3,1,2,3,1,1,2,1,1,46,42,
      42,43,2,3,1,1,2,1,1,2,3,1,2,3,1,1,2,1,1,2,3,1,2,3,1,1,2,1,46,42,
      42,43,46,46,46,46,46,46,46,46,46,46,46,46,46,46,46,46,46,46,46,46,46,46,46,46,46,46,46,42,
      42,43,42,42,42,42,42,42,42,42,42,42,42,42,42,42,42,42,42,42,42,42,42,42,42,42,42,42,46,42
    ]}
  ],
  "collision": [
    1,1,1,1,1,1,1,1,1,1,1,1,1,1,1,1,1,1,1,1,1,1,1,1,1,1,1,1,1,1,
    1,1,1,1,1,1,1,1,1,1,1,1,1,1,1,1,1,1,1,1,1,1,1,1,1,1,1,1,1,1,
    1,1,0,0,0,0,0,0,0,0,0,0,0,0,0,0,0,0,0,0,0,0,0,0,0,0,0,0,1,1,
    1,1,0,0,0,0,0,0,0,0,0,0,0,0,0,0,0,0,0,0,0,0,0,0,0,0,0,0,1,1,
    1,1,0,0,0,0,0,0,0,0,0,0,0,0,0,0,0,0,0,0,0,0,0,0,0,0,0,0,1,1,
    1,1,0,0,0,0,0,0,0,0,0,0,0,0,0,0,0,0,0,0,0,0,0,0,0,0,0,0,1,1,
    1,1,0,0,0,0,0,0,0,0,0,0,0,0,0,0,0,0,0,0,0,0,0,0,0,0,0,0,1,1,
    1,1,0,0,0,0,0,0,0,0,0,0,0,0,0,0,0,0,0,0,0,0,0,0,0,0,0,0,1,1,
    1,1,0,0,0,0,0,0,0,0,0,0,0,0,0,0,0,0,0,0,0,0,0,0,0,0,0,0,1,1,
    1,1,0,0,0,0,0,0,0,0,0,0,0,0,0,0,0,0,0,0,0,0,0,0,0,0,0,0,1,1,
    1,1,0,0,0,0,0,0,0,0,0,0,0,0,0,0,0,0,0,0,0,0,0,0,0,0,0,0,1,1,
    1,1,0,0,0,0,0,0,0,0,0,0,0,0,0,0,0,0,0,0,0,0,0,0,0,0,0,0,1,1,
    1,1,0,0,0,0,0,0,0,0,0,0,0,0,0,0,0,0,0,0,0,0,0,0,0,0,0,0,1,1,
    1,1,0,0,0,0,0,0,0,0,0,0,0,0,0,0,0,0,0,0,0,0,0,0,0,0,0,0,1,1,
    1,1,0,0,0,0,0,0,0,0,0,0,0,0,0,0,0,0,0,0,0,0,0,0,0,0,0,0,1,1,
    1,1,0,0,0,0,0,0,0,0,0,0,0,0,0,0,0,0,0,0,0,0,0,0,0,0,0,0,1,1,
    1,1,0,0,0,0,0,0,0,0,0,0,0,0,0,0,0,0,0,0,0,0,0,0,0,0,0,0,1,1,
    1,1,0,0,0,0,0,0,0,0,0,0,0,0,0,0,0,0,0,0,0,0,0,0,0,0,0,0,1,1,
    1,1,1,1,1,1,1,1,1,1,1,1,1,1,1,1,1,1,1,1,1,1,1,1,1,1,1,1,1,1,
    1,1,1,1,1,1,1,1,1,1,1,1,1,1,1,1,1,1,1,1,1,1,1,1,1,1,1,1,1,1
  ],
  "portals": [
  ],
  "objects": [

  ],
  "npcs": [
    {"name":"Bobby","x":256,"y":224,"dir":0,"sprite_atlas_id":0,"interact_radius":40,"hostile":false,"aggro_range":150,"attack_range":32,"move_speed":30,"wander_interval":4,"has_battle":false,"dialogue":[{"speaker":"Bobby","text":"You idjits better be prepared before heading out."},{"speaker":"Bobby","text":"I've got some supplies if you need 'em."},{"speaker":"Bobby","text":"Also, watch your back. Something ain't right in this town."}]},
    {"name":"???","x":640,"y":224,"dir":1,"sprite_atlas_id":1,"interact_radius":40,"hostile":false,"aggro_range":150,"attack_range":32,"move_speed":25,"wander_interval":5,"has_battle":false,"dialogue":[{"speaker":"???","text":"You shouldn't be poking around here, hunter."},{"speaker":"???","text":"I can smell it on you... the stench of righteousness."}]},
    {"name":"Vampire","x":608,"y":448,"dir":2,"sprite_atlas_id":2,"interact_radius":40,"hostile":true,"aggro_range":160,"attack_range":36,"move_speed":65,"wander_interval":3,"has_battle":true,"battle_enemy":"Vampire","battle_hp":60,"battle_atk":15,"dialogue":[{"speaker":"Vampire","text":"The night is young, hunter..."},{"speaker":"Vampire","text":"You reek of dead man's blood. Cute."}]},
    {"name":"Azazel","x":224,"y":480,"dir":0,"sprite_atlas_id":3,"interact_radius":40,"hostile":false,"aggro_range":150,"attack_range":32,"move_speed":20,"wander_interval":6,"has_battle":false,"dialogue":[{"speaker":"Azazel","text":"Well, well... the Winchester boys."},{"speaker":"Azazel","text":"You have no idea what's coming."},{"speaker":"Azazel","text":"I've got plans for your brother, Dean."},{"speaker":"Dean","text":"You son of a bitch."}]}
  ]
}
